script	corelanguage
commands	corelanguage
code	corelanguage
assignment	corelanguage
var	corelanguage
Number	corelanguage
if	corelanguage
Wall	corelanguage
libraries	corelanguage
Colors	corelanguage
art	corelanguage
NumberSubtract	Number
Board	corelanguage
Sprite	corelanguage
for	corelanguage
NumberMultiply	Number
Math	corelanguage
String	corelanguage
NumberGt	Number
BoardCreatePicture	Board
Sound	corelanguage
SoundPlay	Sound
NumberAdd	Number
inlineActions	corelanguage
events	corelanguage
SpriteY	Sprite
Boolean	corelanguage
data	corelanguage
Media	corelanguage
WallSetBackgroundPicture	Wall
actionParameter	corelanguage
StringPostToWall	String
NumberLt	Number
ColorsRandom	Colors
BoardWidth	Board
BoardHeight	Board
SpriteSetSpeedY	Sprite
SpriteX	Sprite
MathRandomRange	Math
SpriteSetPos	Sprite
foreach	corelanguage
NumberDivide	Number
BoardAddOnEveryFrame	Board
BooleanOr	Boolean
BoardCreateSpriteSet	Board
SpriteSet	Sprite
SpriteSetAdd	Sprite
SpriteSetWidth	Sprite
SpriteSetSpeedX	Sprite
BoardSetGravity	Board
BoardPostToWall	Board
SpriteOnTap	Sprite
comment	corelanguage
exportable	corelanguage
BoardUpdateOnWall	Board
Picture	corelanguage
StringConcatOp	String
SpriteSetColor	Sprite
BoardCreateText	Board
NumberEq	Number
SpriteSetY	Sprite
Time	corelanguage
Senses	corelanguage
SpriteSpeedX	Sprite
SpriteSetX	Sprite
WallSetBackground	Wall
BoardEvolve	Board
SpriteSetHeight	Sprite
elseIf	corelanguage
Vector3	corelanguage
PicturePostToWall	Picture
Vector3X	corelanguage
MediaCreateLandscapeBoard	Media
ColorsBlack	Colors
WallClear	Wall
MathRandom	Math
BoardCreateEllipse	Board
Box	corelanguage
BoxIsInit	Box
pages	corelanguage
ColorsRed	Colors
NumberToString	Number
Collections	corelanguage
ColorsWhite	Colors
SensesAccelerationQuick	Senses
BooleanNot	Boolean
Web	corelanguage
SpriteOverlapsWith	Sprite
MediaSongs	Media
StringCollection	String
Song	corelanguage
boxed	corelanguage
BooleanAnd	Boolean
Songs	corelanguage
StringEquals	String
ColorsBlue	Colors
SpriteSetText	Sprite
while	corelanguage
SpriteSetAngularSpeed	Sprite
SpriteWidth	Sprite
recordDef	corelanguage
ColorsWheel	Colors
SongPlay	Song
DateTime	Date
Color	corelanguage
SpriteSetFriction	Sprite
SongsRandom	Songs
ColorsOrange	Colors
BoxOnTapped	Box
BoardCreateRectangle	Board
StringCollectionAdd	String
CollectionsCreateStringCollection	Collections
BoxUseHorizontalLayout	Box
WallAskString	Wall
TimeSleep	Time
BoxSetWidth	Box
TimeNow	Time
